0000000000000000000000000000000000000000000000000000000000000000000000000000000000000000000000000000
0000000000000000000000000000000000000000000000000000000000000000000000000000000000000000000000000000
0000000000000000000000000000000000000000000000000000000000000000000000000000000000000000000000000000
0000000000000000000000000000000000000000000000000000000000000000000000000000000000000000000000000000
0000000000000000000000000000000000000000000000000000000000000000000000000000000000000000000000000000
0000000000000000000000000000000000000000000000000000000000000000000000000000000000000000000000000000
0000000000000000000000000000000000000000000000000000000000000000000000000000000000000000000000000000
0000000000000000000000000000000000000000000000000000000000000000000000000000000000000000000000000000
0000000000000000000000000000000000000000000000000000000000000000010000000000000000000000000000000000
0000000000000000000000000000000000000000000000000000000000000000110000000000000000000000000000000000
0000000000000000000000000000000000000000000000000000000000000001110000000000000000000000000000000000
0000000000000000000000000000000000000000000000000000000000000011100000000000000000000000000000000000
0000000000000000000000000000000000000000000000000000000000000111000000000000000000000000000000000000
0000000000000000000000000000000000000000000000000000000000011110000000000000002222222000000000000000
0000000000000000000000000000000000000000000000000000000001111110000000000000222222222200000000000000
0000000000000000000000000000000000000000000000000000000011111000000000000022222222222220000000000000
0000000000000000011111111111100000000000000000000000000011110000000000222222222222222220000000000000
0000000000000000000011111111111111100000000000000000000011000000000022222222222222222222222200000000
0000000000000000000000011111111111110000000000000000000000000000000022222222222222222222222222200000
0000000000000000000000000111111111111111111111110000000000000000000222222222222222222222222222222000
0000000000000000000000000000000000001111111111111000000000000000000222222222222222222222222222222000
0000000000000000000000000000000000001111111111111111000000000000002222222222222223222222222222222000
0000000000000000000000000000000000000111111111111100000000000000000222222222222222222222222222222200
0000000000000000000000000000000000000011111111111000000000000000000222222222222222222222222222222200
0000000000000000000000000000000000000001111111110000000000000000000222222222222222222222222222222000
0000000000000000000000000000000000001111111110000000000000000000000222222222222222222222222222200000
0000000000000000000000000000000000000000111111110000000000000000000022222222222222222222222200000000
0000000000000000000000000000000000000000001111111100000000000000000000022222222222222222222222000000
0000000000000000000000000000000000000000001111111100000000000000000000000000222222222222222000000000
0000000000000000000000000000000000000000000111111100000000000000000000000000002222222222222220000000
0000000000000000000000000000000000000000000011111111000000000000000000000000000022222222222000000000
0000000000000000000000000000000000000000000001100000000000000000000000000000000022222222222000000000
0000000000000000000000000000000000000000000000110000000000000000000000000000000000222222220000000000
0000000000000000000000000000000000000000000000000000000000000000000000000000000000000000000000000000
0000000000000000000000000000000000000000000000000000000000000000000000000000000000000000000000000000
0000000000000000000000000000000000000000000000000000000000000000000000000000000000000000000000000000
0000000000000000000000000000000000000000000000000000000000000000000000000000000000000000000000000000
0000000000000000000000000000000000000000000000000000000000000000000000000000000000000000000000000000
0000000000000000000000000000000000000000000000000000000000000000000000000000000000000000000000000000
0000000000000000000000000000000000000000000000000000000000000000000000000000000000000000000000000000
0000000000000000000000000000000000000000000000000000000000000000000000000000000000000000000000000000
0000000000000000000000000000000000000000000000000000000000000000000000000000000000000000000000000000
0000000000000000000000000000000000000000000000000000000000000000000000000000000000000000000000000000
0000000000000000000000000000000000000000000000000000000000000000000000000000000000000000000000000000
0000000000000000000000000000000000000000000000000000000000000000000000000000000000000000000000000000